MMMMMMMMMMMMSMMMMMMM
MSSSSSSSSSSSSSSSSSSM
MSSSSSSSSSSSSSSSSSSM
MSSSSSSSSSSPPPPSSSSM
MSSSSSSSSSSSSSSSSSSM
MSSSSSSSSSSSSSSSSSSS
MSSSSSPPPSSSSSSSSSSM
MSSSSSSSSSSSSSSSSSSM
MSSSSSSSSSSSSSESSSSM
SSSSSSSSSSSSSSSSSSSM
MSSSSSSSSPSSSSSSSSSM
MSSSSSSSSSSSSSSSSSSM
MSSSSSSSSSSSSSSSSSSM
MSSSSSSSSSSSSSSSSSSM
MLSMSSMMMMMSSSSSSSSM
MSMSSSMMSSMSSSSSSSSM
MSMMMMMSSMMMSMSSSSSM
MMMSMSMSSSSSSMSMMMSM
MSMSSSSSSMSMSMSSSSSM
MMMSMMMMMMMMMMMMMMMM