MMMMMMMMMMMMSMMMMMMM
MSSSSSSSSSSSSSSSSSSM
MSSSSSSSSSSSSSSSSSSM
MSSSSSSSSSSPPPPSSSSM
MSSSSSSSSSSSSSSSSSSM
MSSSSSSSSSSSSSSSSSSS
MSSSSSPPPSSSSSSSSSSM
MSSSSSSSSSSSSSSSSSSM
MSSSSSSSSSSSSSESSSSM
SSSSSSSSSSSSSSSSSSSM
MSSSSSSSSPSSSSSSSSSM
MSSSSSSSSSSSSSSSSSSM
MSSSSSSSSSSSSSSSSSSM
MSSSSSSSSSSSSSSSSSSM
MSSMSSMMMMMSSSSSSSSM
MSMSSSMMSSMSSSSSSSSM
MSMMMMMSSMMMSMSSSSSM
MSMSMSMSSSSSSMSMMMSM
MSMSSSSSSMSMSMSSSSSM
MMMSMMMMMMMMMMMMMMMM
