MMMMMMMMMMMMSMMMMMMM
MPSMMSSSLSSMSMPPMSLM
MSSSSSMPMMMMSSSSMSSM
MSMPMSSSSSSMMMMSMMSM
MSMPMSSMMSSSSSSSSSSM
MSMMMMSSMSMSSMMSMMMM
MSSSMSSMMSMSSSMSMSSM
MMMSSSSSSSSSMMMSSSSM
MMSSMMMSSMMSPSMSSMSM
MSSMPSMSSSSSSSSSMPSM
MSSSSSSSSMMMMSSSSMSM
MSMMMMSSSMPSMMMSSSSM
MSMSSSSSSMPSSPSSSSSM
MSMMMSSSMMMSSMSSMMSM
MSPPSSPSSSMSSMMSSSSM
MMMSMMSMSSSSMMMSMMMM
MEMSSMMMSSSMSMSSMSSM
MSMSSSSMSMMMMSSSSPSM
MSSSPSSMSSSSSPMSMSLM
MMMMMMMMSMMMMMMMMMMM
