MMMMMMMMMMMMSMMMMMMM
MSSMMSSSLSSMSMSSMSLM
MSSSSSMSMMMMSSSSMSSM
MSMSMSSSSSSMMMMSMMSM
MSMSMSSMMSSSSSSSSSSM
MSMMMMSSMSMSSMMSMMMM
MSSSMSSMMSMSSSMSMSSM
MMMSSSSSSSSSMMMSSSSM
MMSSMMMSSMMSSSMSSMSM
MSSMSSMSSSSSSSSSMSSM
MSSSSSSSSMMMMSSSSMSM
MSMMMMSSSMSSMMMSSSSM
MSMSSSSSSMSSSSSSSSSM
MSMMMSSSMMMSSMSSMMSM
MSSSSSSSSSMSSMMSSSSM
MMMSMMSMSSSSMMMSMMMM
MEMSSMMMSSSMSSSSMSSM
MSMSSSSMSMMMSSMSSSSM
MSSSSSSMSSSSSSMSMSSM
MMMMMMMMSMMMMMMMMMMM
