MMMMMMMMMMMMSMMMMMMM
MPSMMSSSESSMSMPPMSLM
MSSSSSMPMMMMSSSSMSSM
MSMPMSSSSSSMMMMSMMSM
MSMPMSSMMSSSSSSSSSSM
MSMMMMSSMSMSSMMSMMMM
MSSSMSSMMSMSSSMSMSSM
MMMSSCSSSSSSMMMSSSSM
MMSSMMMSSMMSPSMSSMSM
MSSMPSMSSSSSSSSSMPSM
MSSSSSSSSMMMMSCSSMSM
MSMMMMSSSMPSMMMSSSSM
MSMSSSSSSMPSSPSSSSSM
MSMMMSSSMMMSSMSSMMSM
MSPPSSPSSSMSSMMSSSSM
MMMSMMSMSSSSMMMSMMMM
MEMSSMMMSSSMSMSSMSSM
MSMSSSSMSMMMMSSSSPSM
MSSSPSSMSSSSSPMSMSEM
MMMMMMMMSMMMMMMMMMMM