SSSSMMMMMMMMMMMMMMMMMMMM
SSSSSSMSSSMSSSPSSMSSSSSM
SSSSMPMSMSSSMMMMPMSMMMSM
MMSMMSSSPSMSMSSMMMSMSSSM
MSESSSMMSMMSMMSMSSSMSMMM
MSMMMMMSSSMSSLSMSMMMSSSM
MSSPSSSSMSSSMMMMSMSMMMSM
MSMMMSMMMMMMMSSSSMSSPMSM
MSMPSSSSPSSMSSMSMMSMSMSM
MSMSMMMSMMSMMMMSMSSPSMSM
MSMSPSMPSMSSMSSSMSMMMMSM
MSMSMSMSMMMSMSMMMSMSSESM
MSMSMMMSSSMSMSSSSSMSMMMM
MSMSSPPSMSMSSSMMMMMSSMSM
MSMMMSMMMMMMSMMSSSMMSMSM
MSSSMMMSSLSSSSMSMSSSSMSM
MSMSSPSSMMMSMMMMMSMMMMCM
MSSSMPMMMSMSMSSSMSMSMSSM
MMMMMSMSSSMSESMPMSMSSMPM
MSSSSSMSMSMMMMMMMSMMSSSM
MSMMMMMSMSSSMSSSSSSSSSSS
MSMSPSMSMMMMMSMMMMMSSSSS
MSSSMSSSMSSPSSSSSSMSSSSS
MMMMMMMMMMMMMMMMMMMSSSSS