SSSSMMMMMMMMMMMMMMMMMMMM
SSSSSSMSSSMSSSSSSMSSSSSM
SSSSMSMSMSSSMMMMSMSMMMSM
MMSMMSSSSSMSMSSMMMSMSSSM
MSSSSSMMSMMSMMSMSSSMSMMM
MSMMMMMSSSMSSSSMSMMMSSSM
MSSSSSSSMSSSMMMMSMSMMMSM
MSMMMSMMMMMMMSSSSMSSSMSM
MSMSSSSSSSSMSSMSMMSMSMSM
MSMSMMMSMMSMMMMSMSSSSMSM
MSMSSSMSSMSSMSSSMSMMMMSM
MSMSMSMSMMMSMSMMMSMSSSSM
MSMSMMMSSSMSMSSSSSMSMMMM
MSMSSSSSMSMSSSMMMMMSSMSM
MSMMMSMMMMMMSMMSSSMMSMSM
MSSSMMMSSSSSSSMSMSSSSMSM
MSMSSSSSMMMSMMMMMSMMMMSM
MSSSMSMMMSMSMSSSMSMSMSSM
MMMMMSMSSSMSSSMSMSMSSMSM
MSSSSSMSMSMMMMMMMSMMSSSM
MSMMMMMSMSSSMSSSSSSSSSSS
MSMSSSMSMMMMMSMMMMMSSSSS
MSSSMSSSMSSSSSSSSSMSSSSS
MMMMMMMMMMMMMMMMMMMSSSSS
